HHHHHHHHHHHHHHHHHHH
H                 H
H        H        H
H    A   H   B    H
H        H        H
H                 H
HHHHHHHHHHHHHHHHHHH