HHHHHHHHHHHHHHHHHHHHHHHHHHHHHHHHHHHHHHHHHHHHH
H                                           H
H                                           H
H                                           H
H                                           H
H        HHH     H      HHH    HHHH         H
H         H      HH      H    HH  H         H
H        BH     H H      H    HA            H
H         H     HHHH     H    H             H
H         H    H   H     H    HH            H
H        HHH   H   HH   HHH    HHHH         H
H                                           H
H                                           H
H                                           H
H                                           H
HHHHHHHHHHHHHHHHHHHHHHHHHHHHHHHHHHHHHHHHHHHHH
